### ## # # #
#E     ## ##
 ###   #  # 
#  #   #  ##
#    #   ###
  ###  ## ##
S###   ### #