##########
#        E
### # ####
# # #    #
# ##### ##
#     #  #
## ## ## #
#  #   # #
# ## # # #
S #  #   #
##########
